N,D,L,U1,U2,autotune,fallback clusterer FLOPs,main clusterer FLOPs,pre-clusterer FLOPs,total FLOPs
1000,256,inf,inf,inf,False,7295426,0,0,7295426
1000,256,0,inf,inf,False,0,805775151,0,805775151
1000,256,50,inf,inf,False,0,813379826,0,813379826
1000,256,50,300,inf,False,0,61675238,6778939,68454177
1000,256,50,100,inf,False,0,12463184,6790185,19253369
1000,256,50,300,600,False,0,58801268,2591922,61393190
1000,256,50,100,600,False,0,11862343,2593427,14455770
1000,256,50,100,300,False,0,12671008,693228,13364236
1500,256,inf,inf,inf,False,15980769,0,0,15980769
1500,256,0,inf,inf,False,0,1605642914,0,1605642914
1500,256,50,inf,inf,False,0,1612784102,0,1612784102
1500,256,50,300,inf,False,0,61567495,14844411,76411906
1500,256,50,100,inf,False,0,11158420,14880702,26039122
1500,256,50,300,600,False,0,61093472,2495333,63588805
1500,256,50,100,600,False,0,11327371,2490956,13818327
1500,256,50,100,300,False,0,11274726,736215,12010941
2000,256,inf,inf,inf,False,25742961,0,0,25742961
2000,256,0,inf,inf,False,0,2671892259,0,2671892259
2000,256,50,inf,inf,False,0,2686853677,0,2686853677
2000,256,50,300,inf,False,0,61371238,28119101,89490339
2000,256,50,100,inf,False,0,12181792,28265500,40447292
2000,256,50,300,600,False,0,59434265,2626495,62060760
2000,256,50,100,600,False,0,11572232,2501902,14074134
2000,256,50,100,300,False,0,12238518,694940,12933458
2500,256,inf,inf,inf,False,44183682,0,0,44183682
2500,256,0,inf,inf,False,0,3973967610,0,3973967610
2500,256,50,inf,inf,False,0,3971977612,0,3971977612
2500,256,50,300,inf,False,0,60418885,44554840,104973725
2500,256,50,100,inf,False,0,11588030,44505743,56093773
2500,256,50,300,600,False,0,61472267,2515598,63987865
2500,256,50,100,600,False,0,12137210,2550051,14687261
2500,256,50,100,300,False,0,12631807,689259,13321066
3000,256,inf,inf,inf,False,63690626,0,0,63690626
3000,256,0,inf,inf,False,0,8718283252,0,8718283252
3000,256,50,inf,inf,False,0,8689672086,0,8689672086
3000,256,50,300,inf,False,0,60380731,64047975,124428706
3000,256,50,100,inf,False,0,11735689,63859511,75595200
3000,256,50,300,600,False,0,63573960,2484571,66058531
3000,256,50,100,600,False,0,11582147,2484987,14067134
3000,256,50,100,300,False,0,11460037,698231,12158268
3500,256,inf,inf,inf,False,87466210,0,0,87466210
3500,256,0,inf,inf,False,0,11781101498,0,11781101498
3500,256,50,inf,inf,False,0,11731246045,0,11731246045
3500,256,50,300,inf,False,0,61899153,86983519,148882672
3500,256,50,100,inf,False,0,11390811,87411802,98802613
3500,256,50,300,600,False,0,62307631,2495387,64803018
3500,256,50,100,600,False,0,11185250,2510609,13695859
3500,256,50,100,300,False,0,12236061,694891,12930952
4000,256,inf,inf,inf,False,114501159,0,0,114501159
4000,256,0,inf,inf,False,0,15503103750,0,15503103750
4000,256,50,inf,inf,False,0,15531610457,0,15531610457
4000,256,50,300,inf,False,0,61166665,114792262,175958927
4000,256,50,100,inf,False,0,11783021,115007178,126790199
4000,256,50,300,600,False,0,60838787,2482735,63321522
4000,256,50,100,600,False,0,12463857,2634699,15098556
4000,256,50,100,300,False,0,11977734,733569,12711303
4500,256,inf,inf,inf,False,145977985,0,0,145977985
4500,256,0,inf,inf,False,0,19322550292,0,19322550292
4500,256,50,inf,inf,False,0,19319486521,0,19319486521
4500,256,50,300,inf,False,0,59593000,145644446,205237446
4500,256,50,100,inf,False,0,12569174,145281142,157850316
4500,256,50,300,600,False,0,60086101,2498756,62584857
4500,256,50,100,600,False,0,11513215,2484343,13997558
4500,256,50,100,300,False,0,11889999,733081,12623080
5000,256,inf,inf,inf,False,180362305,0,0,180362305
5000,256,0,inf,inf,False,0,23837783986,0,23837783986
5000,256,50,inf,inf,False,0,23811473104,0,23811473104
5000,256,50,300,inf,False,0,60023126,180694237,240717363
5000,256,50,100,inf,False,0,11327545,180510956,191838501
5000,256,50,300,600,False,0,60074467,2489553,62564020
5000,256,50,100,600,False,0,12168115,2650183,14818298
5000,256,50,100,300,False,0,11424238,721294,12145532
1000,256,inf,inf,inf,True,6777621,0,0,6777621
1000,256,0,inf,inf,True,0,2375365940,0,2375365940
1000,256,50,inf,inf,True,0,2392863849,0,2392863849
1000,256,50,300,inf,True,0,174793863,6675266,181469129
1000,256,50,100,inf,True,0,34918409,6679245,41597654
1000,256,50,300,600,True,0,175330408,2483768,177814176
1000,256,50,100,600,True,0,35416715,2496081,37912796
1000,256,50,100,300,True,0,36311504,704783,37016287
1500,256,inf,inf,inf,True,14735009,0,0,14735009
1500,256,0,inf,inf,True,0,4645184544,0,4645184544
1500,256,50,inf,inf,True,0,4609126926,0,4609126926
1500,256,50,300,inf,True,0,175547713,14670746,190218459
1500,256,50,100,inf,True,0,35947650,14702853,50650503
1500,256,50,300,600,True,0,177733442,2477168,180210610
1500,256,50,100,600,True,0,35527318,2511482,38038800
1500,256,50,100,300,True,0,35483844,686935,36170779
2000,256,inf,inf,inf,True,25861699,0,0,25861699
2000,256,0,inf,inf,True,0,7734404800,0,7734404800
2000,256,50,inf,inf,True,0,7723691514,0,7723691514
2000,256,50,300,inf,True,0,178015468,28384771,206400239
2000,256,50,100,inf,True,0,34797321,28945176,63742497
2000,256,50,300,600,True,0,173681076,2501139,176182215
2000,256,50,100,600,True,0,36429326,2483422,38912748
2000,256,50,100,300,True,0,34526804,698514,35225318
2500,256,inf,inf,inf,True,44315219,0,0,44315219
2500,256,0,inf,inf,True,0,11613422206,0,11613422206
2500,256,50,inf,inf,True,0,11583245872,0,11583245872
2500,256,50,300,inf,True,0,176981653,44523447,221505100
2500,256,50,100,inf,True,0,37606862,44408217,82015079
2500,256,50,300,600,True,0,175674555,2487436,178161991
2500,256,50,100,600,True,0,35246136,2599164,37845300
2500,256,50,100,300,True,0,35814961,737693,36552654
3000,256,inf,inf,inf,True,63940832,0,0,63940832
3000,256,0,inf,inf,True,0,25080424111,0,25080424111
3000,256,50,inf,inf,True,0,25412024311,0,25412024311
3000,256,50,300,inf,True,0,179986207,63700414,243686621
3000,256,50,100,inf,True,0,35248411,63903040,99151451
3000,256,50,300,600,True,0,177414275,2479488,179893763
3000,256,50,100,600,True,0,36522100,2610219,39132319
3000,256,50,100,300,True,0,34848288,730514,35578802
3500,256,inf,inf,inf,True,87399996,0,0,87399996
3500,256,0,inf,inf,True,0,34506501065,0,34506501065
3500,256,50,inf,inf,True,0,34375469141,0,34375469141
3500,256,50,300,inf,True,0,180615625,87482561,268098186
3500,256,50,100,inf,True,0,35207660,87000015,122207675
3500,256,50,300,600,True,0,176448517,2494846,178943363
3500,256,50,100,600,True,0,34828905,2616046,37444951
3500,256,50,100,300,True,0,36864478,722490,37586968
4000,256,inf,inf,inf,True,114958190,0,0,114958190
4000,256,0,inf,inf,True,0,45572677053,0,45572677053
4000,256,50,inf,inf,True,0,45538766809,0,45538766809
4000,256,50,300,inf,True,0,175425148,114841345,290266493
4000,256,50,100,inf,True,0,34665177,115129135,149794312
4000,256,50,300,600,True,0,179286032,2483116,181769148
4000,256,50,100,600,True,0,34375622,2635511,37011133
4000,256,50,100,300,True,0,35326136,726670,36052806
4500,256,inf,inf,inf,True,146075876,0,0,146075876
4500,256,0,inf,inf,True,0,55593578530,0,55593578530
4500,256,50,inf,inf,True,0,55738069936,0,55738069936
4500,256,50,300,inf,True,0,181674652,145611613,327286265
4500,256,50,100,inf,True,0,35783651,145993165,181776816
4500,256,50,300,600,True,0,175696236,2504265,178200501
4500,256,50,100,600,True,0,35097730,2621604,37719334
4500,256,50,100,300,True,0,35755040,724696,36479736
5000,256,inf,inf,inf,True,180600260,0,0,180600260
5000,256,0,inf,inf,True,0,68598492361,0,68598492361
5000,256,50,inf,inf,True,0,68708520803,0,68708520803
5000,256,50,300,inf,True,0,177634897,180814044,358448941
5000,256,50,100,inf,True,0,35520127,180960274,216480401
5000,256,50,300,600,True,0,178155224,2509894,180665118
5000,256,50,100,600,True,0,35942804,2620634,38563438
5000,256,50,100,300,True,0,34707729,715449,35423178
